name,UK Football Leagues Map
width,120
height,100

HGGHGGHGGHGGHGGHGGHGGHGGHGGHGGHGGHGGHGGHGGHGGHGGHGGHGGHGGHGGHGGHGGHGGHGGHGGHGGHGGHGGHGGHGGHGGHGGHGGHGGHGGHGGHGGHGGHGGHGG
GGHGGHGGHGGHGGHGGHGGHGGHGGHGGHGGHGGHGGHGGHGGHGGHGGHGGHGGHGGHGGHGGHGGHGGHGGHGGHGGHGGHGGHGGHGGHGGHGGHGGHGGHGGHGGHGGHGGHGGH
GHGGHGGHGGHGGHGGHGGHGGHGGHGGHGGHGGHGGHGGHGGHGGHGGHGGHGGHGGHGGHGGHGGHGGHGGHGGHGGHGGHGGHGGHGGHGGHGGHGGHGGHGGHGGHGGHGGHGGHG
HGGHGGHGGHGGHGGHGGHGGHGGHGGHGGHGGHGGHGGHGGHGGHGGHGGHGGHGGHGGHGGHGGHGGHGGHGGHGGHGGHGGHGGHGGHGGHGGHGGHGGHGGHGGHGGHGGHGGHGG
GGHGGHGGHGGHGGHGGHGGHGGHGGHGGHGGHGGHGGHGGHGGHGGHGGHGGHGGHGGHGGHGGHGGHGGHGGHGGHGGHGGHGGHGGHGGHGGHGGHGGHGGHGGHGGHGGHGGHGGH
GHGGHGGHGGHGGHGGHGGHGGHGGHGGHGGHGGHGGHGGHGGHGGHGGHGGHGGHGGHGGHGGHGGHGGHGGHGGHGGHGGHGGHGGHGGHGGHGGHGGHGGHGGHGGHGGHGGHGGHG
HGGHGGHGGHGGHGGHGGHGGHGGHGGHGGHGGHGGHGGHGGHGGHGGHGGHGGHGGHGGHGGHGGHGGHGGHGGHGGHGGHGGHGGHGGHGGHGGHGGHGGHGGHGGHGGHGGHGGHGG
GGHGGHGGHGGHGGHGGHGGHGGHGGHGGHGGHGGHGGHGGHGGHGGHGGHGGHGGHGGHGGHGGHGGHGGHGGHGGHGGHGGHGGHGGHGGHGGHGGHGGHGGHGGHGGHGGHGGHGGH
GHGGHGGHGGHGGHGGHGGHGGHGGHGGHGGHGGHGGHGGHGGHGGHGGHGGHGGHGGHGGHGGHGGHGGHGGHGGHGGHGGHGGHGGHGGHGGHGGHGGHGGHGGHGGHGGHGGHGGHG
HGGHGGHGGHGGHGGHGGHGGHGGHGGHGGHGGHGGHGGHGGHGGHGGHGGHGGHGGHGGHGGHGGHGGHGGHGGHGGHGGHGGHGGHGGHGGHGGHGGHGGHGGHGGHGGHGGHGGHGG
FHFHFHFHFHFHFHFGGGPGGGPGGGPGGGPGGGPGGGPGGGPGGGPGGGPGGGPGGGPGGGPGGGPGGGPGGGPGGGPGGGPGGGPGGGPGGGPGGGPGGGPGGGPGGGPGGGPGGGPG
HFHFHFHFHFHFHFHGGPGGGPGGGPGGGPGGGPGGGPGGGPGGGPGGGPGGGPGGGPGGGPGGGPGGGPGGGPGGGPGGGPGGGPGGGPGGGPGGGPGGGPGGGPGGGPGGGPGGGPGG
FHFHFHFHFHFHFHFGPGGGPGGGPGGGPGGGPGGGPGGGPGGGPGGGPGGGPGGGPGGGPGGGPGGGPGGGPGGGPGGGPGGGPGGGPGGGPGGGPGGGPGGGPGGGPGGGPGGGPGGG
HFHFHFHFHFHFHFHPGGGPGGGPGGGPGGGPGGGPGGGPGGGPGGGPGGGPGGGPGGGPGGGPGGGPGGGPGGGPGGGPGGGPGGGPGGGPGGGPGGGPGGGPGGGPGGGPGGGPGGGP
FHFHFHFHFHFHFHFGGGPGGGPGGGPGGGPGGGPGGGPGGGPGGGPGGGPGGGPGGGPGGGPGGGPGGGPGGGPGGGPGGGPGGGPGGGPGGGPGGGPGGGPGGGPGGGPGGGPGGGPG
HFHFHFHFHFHFHFHGGPGGGPGGGPGGGPGGGPGGGPGGGPGGGPGGGPGGGPGGGPGGGPGGGPGGGPGGGPGGGPGGGPGGGPGGGPGGGPGGGPGGGPGGGPGGGPGGGPGGGPGG
FHFHFHFHFHFHFHFGPGGGPGGGPGGGPGGGPGGGPGGGPGGGPGGGPGGGPGGGPGGGPGGGPGGGPGGGPGGGPGGGPGGGPGGGPGGGPGGGPGGGPGGGPGGGPGGGPGGGPGGG
HFHFHFHFHFHFHFHPGGGPGGGPGGGPGGGPGGGPGGGPGGGPGGGPGGGPGGGPGGGPGGGPGGGPGGGPGGGPGGGPGGGPGGGPGGGPGGGPGGGPGGGPGGGPGGGPGGGPGGGP
FHFHFHFHFHFHFHFGGGPGGGPGGGPGGGPGGGPGGGPGGGPGGGPGGGPGGGPGGGPGGGPGGGPGGGPGGGPGGGPGGGPGGGPGGGPGGGPGGGPGGGPGGGPGGGPGGGPGGGPG
HFHFHFHFHFHFHFHGGPGGGPGGGPGGGPGGGPGGGPGGGPGGGPGGGPGGGPGGGPGGGPGGGPGGGPGGGPGGGPGGGPGGGPGGGPGGGPGGGPGGGPGGGPGGGPGGGPGGGPGG
FHFHFHFHFHFHFHFGPGGGPGGGPGGGPGGGPGGGPGGGPGGGPGGGPGGGPGGGPGGGPGGGPGGGPGGGPGGGPGGGPGGGPGGGPGGGPGGGPGGGPGGGPGGGPGGGPGGGPGGG
HFHFHFHFHFHFHFHPGGGPGGGPGGGPGGGPGGGPGGGPGGGPGGGPGGGPGGGPGGGPGGGPGGGPGGGPGGGPGGGPGGGPGGGPGGGPGGGPGGGPGGGPGGGPGGGPGGGPGGGP
FHFHFHFHFHFHFHFGGGPGGGPGGGPGGGPGGGPGGGPGGGPGGGPGGGPGGGPGGGPGGGPGGGPGGGPGGGPGGGPGGGPGGGPGGGPGGGPGGGPGGGPGGGPGGGPGGGPGGGPG
HFHFHFHFHFHFHFHGGPGGGPGGGPGGGPGGGPGGGPGGGPGGGPGGGPGGGPGGGPGGGPGGGPGGGPGGGPGGGPGGGPGGGPGGGPGGGPGGGPGGGPGGGPGGGPGGGPGGGPGG
FHFHFHFHFHFHFHFGPGGGPGGGPGGGPGGGPGGGPGGGPGGGPGGGPGGGPGGGPGGGPGGGPGGGPGGGPGGGPGGGPGGGPGGGPGGGPGGGPGGGPGGGPGGGPGGGPGGGPGGG
HFHFHFHFHFHFHFHPGGGPGGGPGGGPGGGPGGGPGGGPGGGPGGGPGGGPGGGPGGGPGGGPGGGPGGGPGGGPGGGPGGGPGGGPGGGPGGGPGGGPGGGPGGGPGGGPGGGPGGGP
FHFHFHFHFHFHFHFGGGPGGGPGGGPGGGPGGGPGGGPGGGPGGGPGGGPGGGPGGGPGGGPGGGPGGGPGGGPGGGPGGGPGGGPGGGPGGGPGGGPGGGPGGGPGGGPGGGPGGGPG
HFHFHFHFHFHFHFHGGPGGGPGGGPGGGPGGGPGGGPGGGPGGGPGGGPGGGPGGGPGGGPGGGPGGGPGGGPGGGPGGGPGGGPGGGPGGGPGGGPGGGPGGGPGGGPGGGPGGGPGG
FHFHFHFHFHFHFHFGPGGGPGGGPGGGPGGGPGGGPGGGPGGGPGGGPGGGPGGGPGGGPGGGPGGGPGGGPGGGPGGGPGGGPGGGPGGGPGGGPGGGPGGGPGGGPGGGPGGGPGGG
HFHFHFHFHFHFHFHPGGGPGGGPGGGPGGGPGGGPGGGPGGGPGGGPGGGPGGGPGGGPGGGPGGGPGGGPGGGPGGGPGGGPGGGPGGGPGGGPGGGPGGGPGGGPGGGPGGGPGGGP
FHFHFHFHFHFHFHFGGGPGGGPGGGPGGGPGGGPGGGPGGGPGGGPGGGPGGGPGGGPGGGPGGGPGGGPGGGPGGGPGGGPGGGPGGGPGGGPGGGPGGGPGGGPGGGPGGGPGGGPG
HFHFHFHFHFHFHFHGGPGGGPGGGPGGGPGGGPGGGPGGGPGGGPGGGPGGGPGGGPGGGPGGGPGGGPGGGPGGGPGGGPGGGPGGGPGGGPGGGPGGGPGGGPGGGPGGGPGGGPGG
FHFHFHFHFHFHFHFGPGGGPGGGPGGGPGGGPGGGPGGGPGGGPGGGPGGGPGGGPGGGPGGGPGGGPGGGPGGGPGGGPGGGPGGGPGGGPGGGPGGGPGGGPGGGPGGGPGGGPGGG
HFHFHFHFHFHFHFHPGGGPGGGPGGGPGGGPGGGPGGGPGGGPGGGPGGGPGGGPGGGPGGGPGGGPGGGPGGGPGGGPGGGPGGGPGGGPGGGPGGGPGGGPGGGPGGGPGGGPGGGP
FHFHFHFHFHFHFHFGGGPGGGPGGGPGGGPGGGPGGGPGGGPGGGPGGGPGGGPGGGPGGGPGGGPGGGPGGGPGGGPGGGPGGGPGGGPGGGPGGGPGGGPGGGPGGGPGGGPGGGPG
HFHFHFHFHFHFHFHGGPGGGPGGGPGGGPGGGPGGGPGGGPGGGPGGGPGGGPGGGPGGGPGGGPGGGPGGGPGGGPGGGPGGGPGGGPGGGPGGGPGGGPGGGPGGGPGGGPGGGPGG
FHFHFHFHFHFHFHFGPGGGPGGGPGGGPGGGPGGGPGGGPGGGPGGGPGGGPGGGPGGGPGGGPGGGPGGGPGGGPGGGPGGGPGGGPGGGPGGGPGGGPGGGPGGGPGGGPGGGPGGG
HFHFHFHFHFHFHFHPGGGPGGGPGGGPGGGPGGGPGGGPGGGPGGGPGGGPGGGPGGGPGGGPGGGPGGGPGGGPGGGPGGGPGGGPGGGPGGGPGGGPGGGPGGGPGGGPGGGPGGGP
FHFHFHFHFHFHFHFGGGPGGGPGGGPGGGPGGGPGGGPGGGPGGGPGGGPGGGPGGGPGGGPGGGPGGGPGGGPGGGPGGGPGGGPGGGPGGGPGGGPGGGPGGGPGGGPGGGPGGGPG
HFHFHFHFHFHFHFHGGPGGGPGGGPGGGPGGGPGGGPGGGPGGGPGGGPGGGPGGGPGGGPGGGPGGGPGGGPGGGPGGGPGGGPGGGPGGGPGGGPGGGPGGGPGGGPGGGPGGGPGG
FHFHFHFHFHFHFHFGPGGGPGGGPGGGPGGGPGGGPGGGPGGGPGGGPGGGPGGGPGGGPGGGPGGGPGGGPGGGPGGGPGGGPGGGPGGGPGGGPGGGPGGGPGGGPGGGPGGGPGGG
HFHFHFHFHFHFHFHPGGGPGGGPGGGPGGGPGGGPGGGPGGGPGGGPGGGPGGGPGGGPGGGPGGGPGGGPGGGPGGGPGGGPGGGPGGGPGGGPGGGPGGGPGGGPGGGPGGGPGGGP
FHFHFHFHFHFHFHFGGGPGGGPGGGPGGGPGGGPGGGPGGGPGGGPGGGPGGGPGGGPGGGPGGGPGGGPGGGPGGGPGGGPGGGPGGGPGGGPGGGPGGGPGGGPGGGPGGGPGGGPG
HFHFHFHFHFHFHFHGGPGGGPGGGPGGGPGGGPGGGPGGGPGGGPGGGPGGGPGGGPGGGPGGGPGGGPGGGPGGGPGGGPGGGPGGGPGGGPGGGPGGGPGGGPGGGPGGGPGGGPGG
FHFHFHFHFHFHFHFGPGGGPGGGPGGGPGGGPGGGPGGGPGGGPGGGPGGGPGGGPGGGPGGGPGGGPGGGPGGGPGGGPGGGPGGGPGGGPGGGPGGGPGGGPGGGPGGGPGGGPGGG
HFHFHFHFHFHFHFHPGGGPGGGPGGGPGGGPGGGPGGGPGGGPGGGPGGGPGGGPGGGPGGGPGGGPGGGPGGGPGGGPGGGPGGGPGGGPGGGPGGGPGGGPGGGPGGGPGGGPGGGP
FHFHFHFHFHFHFHFGGGPGGGPGGGPGGGPGGGPGGGPGGGPGGGPGGGPGGGPGGGPGGGPGGGPGGGPGGGPGGGPGGGPGGGPGGGPGGGPGGGPGGGPGGGPGGGPGGGPGGGPG
HFHFHFHFHFHFHFHGGPGGGPGGGPGGGPGGGPGGGPGGGPGGGPGGGPGGGPGGGPGGGPGGGPGGGPGGGPGGGPGGGPGGGPGGGPGGGPGGGPGGGPGGGPGGGPGGGPGGGPGG
FHFHFHFHFHFHFHFGPGGGPGGGPGGGPGGGPGGGPGGGPGGGPGGGPGGGPGGGPGGGPGGGPGGGPGGGPGGGPGGGPGGGPGGGPGGGPGGGPGGGPGGGPGGGPGGGPGGGPGGG
HFHFHFHFHFHFHFHPGGGPGGGPGGGPGGGPGGGPGGGPGGGPGGGPGGGPGGGPGGGPGGGPGGGPGGGPGGGPGGGPGGGPGGGPGGGPGGGPGGGPGGGPGGGPGGGPGGGPGGGP
FHFHFHFHFHFHFHFGGGPGGGPGGGPGGGPGGGPGGGPGGGPGGGPGGGPGGGPGGGPGGGPGGGPGGGPGGGPGGGPGGGPGGGPGGGPGGGPGGGPGGGPGGGPGGGPGGGPGGGPG
HFHFHFHFHFHFHFHGGPGGGPGGGPGGGPGGGPGGGPGGGPGGGPGGGPGGGPGGGPGGGPGGGPGGGPGGGPGGGPGGGPGGGPGGGPGGGPGGGPGGGPGGGPGGGPGGGPGGGPGG
FHFHFHFHFHFHFHFGPGGGPGGGPGGGPGGGPGGGPGGGPGGGPGGGPGGGPGGGPGGGPGGGPGGGPGGGPGGGPGGGPGGGPGGGPGGGPGGGPGGGPGGGPGGGPGGGPGGGPGGG
HFHFHFHFHFHFHFHPGGGPGGGPGGGPGGGPGGGPGGGPGGGPGGGPGGGPGGGPGGGPGGGPGGGPGGGPGGGPGGGPGGGPGGGPGGGPGGGPGGGPGGGPGGGPGGGPGGGPGGGP
FHFHFHFHFHFHFHFGGGPGGGPGGGPGGGPGGGPGGGPGGGPGGGPGGGPGGGPGGGPGGGPGGGPGGGPGGGPGGGPGGGPGGGPGGGPGGGPGGGPGGGPGGGPGGGPGGGPGGGPG
HFHFHFHFHFHFHFHGGPGGGPGGGPGGGPGGGPGGGPGGGPGGGPGGGPGGGPGGGPGGGPGGGPGGGPGGGPGGGPGGGPGGGPGGGPGGGPGGGPGGGPGGGPGGGPGGGPGGGPGG
FHFHFHFHFHFHFHFGPGGGPGGGPGGGPGGGPGGGPGGGPGGGPGGGPGGGPGGGPGGGPGGGPGGGPGGGPGGGPGGGPGGGPGGGPGGGPGGGPGGGPGGGPGGGPGGGPGGGPGGG
HFHFHFHFHFHFHFHPGGGPGGGPGGGPGGGPGGGPGGGPGGGPGGGPGGGPGGGPGGGPGGGPGGGPGGGPGGGPGGGPGGGPGGGPGGGPGGGPGGGPGGGPGGGPGGGPGGGPGGGP
FHFHFHFHFHFHFHFGGGPGGGPGGGPGGGPGGGPGGGPGGGPGGGPGGGPGGGPGGGPGGGPGGGPGGGPGGGPGGGPGGGPGGGPGGGPGGGPGGGPGGGPGGGPGGGPGGGPGGGPG
HFHFHFHFHFHFHFHGGPGGGPGGGPGGGPGGGPGGGPGGGPGGGPGGGPGGGPGGGPGGGPGGGPGGGPGGGPGGGPGGGPGGGPGGGPGGGPGGGPGGGPGGGPGGGPGGGPGGGPGG
FHFHFHFHFHFHFHFGPGGGPGGGPGGGPGGGPGGGPGGGPGGGPGGGPGGGPGGGPGGGPGGGPGGGPGGGPGGGPGGGPGGGPGGGPGGGPGGGPGGGPGGGPGGGPGGGPGGGPGGG
HFHFHFHFHFHFHFHPGGGPGGGPGGGPGGGPGGGPGGGPGGGPGGGPGGGPGGGPGGGPGGGPGGGPGGGPGGGPGGGPGGGPGGGPGGGPGGGPGGGPGGGPGGGPGGGPGGGPGGGP
FHFHFHFHFHFHFHFGGGPGGGPGGGPGGGPGGGPGGGPGGGPGGGPGGGPGGGPGGGPGGGPGGGPGGGPGGGPGGGPGGGPGGGPGGGPGGGPGGGPGGGPGGGPGGGPGGGPGGGPG
HFHFHFHFHFHFHFHGGPGGGPGGGPGGGPGGGPGGGPGGGPGGGPGGGPGGGPGGGPGGGPGGGPGGGPGGGPGGGPGGGPGGGPGGGPGGGPGGGPGGGPGGGPGGGPGGGPGGGPGG
FHFHFHFHFHFHFHFGPGGGPGGGPGGGPGGGPGGGPGGGPGGGPGGGPGGGPGGGPGGGPGGGPGGGPGGGPGGGPGGGPGGGPGGGPGGGPGGGPGGGPGGGPGGGPGGGPGGGPGGG
HFHFHFHFHFHFHFHPGGGPGGGPGGGPGGGPGGGPGGGPGGGPGGGPGGGPGGGPGGGPGGGPGGGPGGGPGGGPGGGPGGGPGGGPGGGPGGGPGGGPGGGPGGGPGGGPGGGPGGGP
FHFHFHFHFHFHFHFGGGPGGGPGGGPGGGPGGGPGGGPGGGPGGGPGGGPGGGPGGGPGGGPGGGPGGGPGGGPGGGPGGGPGGGPGGGPGGGPGGGPGGGPGGGPGGGPGGGPGGGPG
HFHFHFHFHFHFHFHGGPGGGPGGGPGGGPGGGPGGGPGGGPGGGPGGGPGGGPGGGPGGGPGGGPGGGPGGGPGGGPGGGPGGGPGGGPGGGPGGGPGGGPGGGPGGGPGGGPGGGPGG
FHFHFHFHFHFHFHFGPGGGPGGGPGGGPGGGPGGGPGGGPGGGPGGGPGGGPGGGPGGGPGGGPGGGPGGGPGGGPGGGPGGGPGGGPGGGPGGGPGGGPGGGPGGGPGGGPGGGPGGG
HFHFHFHFHFHFHFHPGGGPGGGPGGGPGGGPGGGPGGGPGGGPGGGPGGGPGGGPGGGPGGGPGGGPGGGPGGGPGGGPGGGPGGGPGGGPGGGPGGGPGGGPGGGPGGGPGGGPGGGP
FHFHFHFHFHFHFHFGGGPGGGPGGGPGGGPGGGPGGGPGGGPGGGPGGGPGGGPGGGPGGGPGGGPGGGPGGGPGGGPGGGPGGGPGGGPGGGPGGGPGGGPGGGPGGGPGGGPGGGPG
HFHFHFHFHFHFHFHGGPGGGPGGGPGGGPGGGPGGGPGGGPGGGPGGGPGGGPGGGPGGGPGGGPGGGPGGGPGGGPGGGPGGGPGGGPGGGPGGGPGGGPGGGPGGGPGGGPGGGPGG
FHFHFHFHFHFHFHFGPGGGPGGGPGGGPGGGPGGGPGGGPGGGPGGGPGGGPGGGPGGGPGGGPGGGPGGGPGGGPGGGPGGGPGGGPGGGPGGGPGGGPGGGPGGGPGGGPGGGPGGG
HFHFHFHFHFHFHFHPGGGPGGGPGGGPGGGPGGGPGGGPGGGPGGGPGGGPGGGPGGGPGGGPGGGPGGGPGGGPGGGPGGGPGGGPGGGPGGGPGGGPGGGPGGGPGGGPGGGPGGGP
FHFHFHFHFHFHFHFGGGPGGGPGGGPGGGPGGGPGGGPGGGPGGGPGGGPGGGPGGGPGGGPGGGPGGGPGGGPGGGPGGGPGGGPGGGPGGGPGGGPGGGPGGGPGGGPGGGPGGGPG
HFHFHFHFHFHFHFHGGPGGGPGGGPGGGPGGGPGGGPGGGPGGGPGGGPGGGPGGGPGGGPGGGPGGGPGGGPGGGPGGGPGGGPGGGPGGGPGGGPGGGPGGGPGGGPGGGPGGGPGG
FHFHFHFHFHFHFHFGPGGGPGGGPGGGPGGGPGGGPGGGPGGGPGGGPGGGPGGGPGGGPGGGPGGGPGGGPGGGPGGGPGGGPGGGPGGGPGGGPGGGPGGGPGGGPGGGPGGGPGGG
HFHFHFHFHFHFHFHPGGGPGGGPGGGPGGGPGGGPGGGPGGGPGGGPGGGPGGGPGGGPGGGPGGGPGGGPGGGPGGGPGGGPGGGPGGGPGGGPGGGPGGGPGGGPGGGPGGGPGGGP
FHFHFHFHFHFHFHFGGGPGGGPGGGPGGGPGGGPGGGPGGGPGGGPGGGPGGGPGGGPGGGPGGGPGGGPGGGPGGGPGGGPGGGPGGGPGGGPGGGPGGGPGGGPGGGPGGGPGGGPG
HFHFHFHFHFHFHFHGGPGGGPGGGPGGGPGGGPGGGPGGGPGGGPGGGPGGGPGGGPGGGPGGGPGGGPGGGPGGGPGGGPGGGPGGGPGGGPGGGPGGGPGGGPGGGPGGGPGGGPGG
FHFHFHFHFHFHFHFGPGGGPGGGPGGGPGGGPGGGPGGGPGGGPGGGPGGGPGGGPGGGPGGGPGGGPGGGPGGGPGGGPGGGPGGGPGGGPGGGPGGGPGGGPGGGPGGGPGGGPGGG
CGCGCGCGCGCGCGCGCGCGCGCGCGCGCGCGCGCGCGCGCGCGCGCGCGCGCGCGCGCGCGCGCGCGCGCGCGCGCGCGCGCGCGCGCGCGCGCGCGCGCGCGCGCGCGCGCGCGCGCG
CGCGCGCGCGCGCGCGCGCGCGCGCGCGCGCGCGCGCGCGCGCGCGCGCGCGCGCGCGCGCGCGCGCGCGCGCGCGCGCGCGCGCGCGCGCGCGCGCGCGCGCGCGCGCGCGCGCGCGCG
CGCGCGCGCGCGCGCGCGCGCGCGCGCGCGCGCGCGCGCGCGCGCGCGCGCGCGCGCGCGCGCGCGCGCGCGCGCGCGCGCGCGCGCGCGCGCGCGCGCGCGCGCGCGCGCGCGCGCGCG
CGCGCGCGCGCGCGCGCGCGCGCGCGCGCGCGCGCGCGCGCGCGCGCGCGCGCGCGCGCGCGCGCGCGCGCGCGCGCGCGCGCGCGCGCGCGCGCGCGCGCGCGCGCGCGCGCGCGCGCG
CGCGCGCGCGCGCGCGCGCGCGCGCGCGCGCGCGCGCGCGCGCGCGCGCGCGCGCGCGCGCGCGCGCGCGCGCGCGCGCGCGCGCGCGCGCGCGCGCGCGCGCGCGCGCGCGCGCGCGCG
CGCGCGCGCGCGCGCGCGCGCGCGCGCGCGCGCGCGCGCGCGCGCGCGCGCGCGCGCGCGCGCGCGCGCGCGCGCGCGCGCGCGCGCGCGCGCGCGCGCGCGCGCGCGCGCGCGCGCGCG
CGCGCGCGCGCGCGCGCGCGCGCGCGCGCGCGCGCGCGCGCGCGCGCGCGCGCGCGCGCGCGCGCGCGCGCGCGCGCGCGCGCGCGCGCGCGCGCGCGCGCGCGCGCGCGCGCGCGCGCG
CGCGCGCGCGCGCGCGCGCGCGCGCGCGCGCGCGCGCGCGCGCGCGCGCGCGCGCGCGCGCGCGCGCGCGCGCGCGCGCGCGCGCGCGCGCGCGCGCGCGCGCGCGCGCGCGCGCGCGCG
CGCGCGCGCGCGCGCGCGCGCGCGCGCGCGCGCGCGCGCGCGCGCGCGCGCGCGCGCGCGCGCGCGCGCGCGCGCGCGCGCGCGCGCGCGCGCGCGCGCGCGCGCGCGCGCGCGCGCGCG
CGCGCGCGCGCGCGCGCGCGCGCGCGCGCGCGCGCGCGCGCGCGCGCGCGCGCGCGCGCGCGCGCGCGCGCGCGCGCGCGCGCGCGCGCGCGCGCGCGCGCGCGCGCGCGCGCGCGCGCG
CGCGCGCGCGCGCGCGCGCGCGCGCGCGCGCGCGCGCGCGCGCGCGCGCGCGCGCGCGCGCGCGCGCGCGCGCGCGCGCGCGCGCGCGCGCGCGCGCGCGCGCGCGCGCGCGCGCGCGCG
CGCGCGCGCGCGCGCGCGCGCGCGCGCGCGCGCGCGCGCGCGCGCGCGCGCGCGCGCGCGCGCGCGCGCGCGCGCGCGCGCGCGCGCGCGCGCGCGCGCGCGCGCGCGCGCGCGCGCGCG
CGCGCGCGCGCGCGCGCGCGCGCGCGCGCGCGCGCGCGCGCGCGCGCGCGCGCGCGCGCGCGCGCGCGCGCGCGCGCGCGCGCGCGCGCGCGCGCGCGCGCGCGCGCGCGCGCGCGCGCG
CGCGCGCGCGCGCGCGCGCGCGCGCGCGCGCGCGCGCGCGCGCGCGCGCGCGCGCGCGCGCGCGCGCGCGCGCGCGCGCGCGCGCGCGCGCGCGCGCGCGCGCGCGCGCGCGCGCGCGCG
CGCGCGCGCGCGCGCGCGCGCGCGCGCGCGCGCGCGCGCGCGCGCGCGCGCGCGCGCGCGCGCGCGCGCGCGCGCGCGCGCGCGCGCGCGCGCGCGCGCGCGCGCGCGCGCGCGCGCGCG
CGCGCGCGCGCGCGCGCGCGCGCGCGCGCGCGCGCGCGCGCGCGCGCGCGCGCGCGCGCGCGCGCGCGCGCGCGCGCGCGCGCGCGCGCGCGCGCGCGCGCGCGCGCGCGCGCGCGCGCG
CGCGCGCGCGCGCGCGCGCGCGCGCGCGCGCGCGCGCGCGCGCGCGCGCGCGCGCGCGCGCGCGCGCGCGCGCGCGCGCGCGCGCGCGCGCGCGCGCGCGCGCGCGCGCGCGCGCGCGCG
CGCGCGCGCGCGCGCGCGCGCGCGCGCGCGCGCGCGCGCGCGCGCGCGCGCGCGCGCGCGCGCGCGCGCGCGCGCGCGCGCGCGCGCGCGCGCGCGCGCGCGCGCGCGCGCGCGCGCGCG
CGCGCGCGCGCGCGCGCGCGCGCGCGCGCGCGCGCGCGCGCGCGCGCGCGCGCGCGCGCGCGCGCGCGCGCGCGCGCGCGCGCGCGCGCGCGCGCGCGCGCGCGCGCGCGCGCGCGCGCG